26
16
38 39 38 39 38 39 38 39 19 19 19 19 25 25 19 19 19 19 38 39 38 39 38 39 38 39 
36 37 36 37 36 37 36 37 19 19 19 19 25 25 19 19 19 19 36 37 36 37 36 37 36 37 
38 39 38 39 38 39 38 39 38 39 38 39 25 25 38 39 38 39 38 39 38 39 38 39 38 39 
36 37 36 37 36 37 36 37 36 37 36 37 25 25 36 37 36 37 36 37 36 37 36 37 36 37 
38 39 38 39 18 18 18 17 17 17 17 17 17 17 17 17 17 17 17 16 16 16 38 39 38 39 
36 37 36 37 18 18 18 17 17 17 17 17 17 17 17 17 17 17 17 16 16 16 36 37 36 37 
38 39 38 39 18 18 18 17 17 17 17 17 17 17 17 17 17 17 17 16 16 16 38 39 38 39 
36 37 36 37 34 34 34 17 17 17 17 17 17 17 17 17 17 17 17 34 34 34 36 37 36 37 
38 39 38 39 18 18 18 17 17 17 17 17 17 17 17 17 17 17 17 16 16 16 38 39 38 39 
36 37 36 37 18 18 18 17 17 17 17 17 17 17 17 17 17 17 17 16 16 16 36 37 36 37 
38 39 38 39 18 18 18 17 17 17 17 17 17 17 17 17 17 17 17 16 16 16 38 39 38 39 
36 37 36 37 18 18 18 17 17 17 17 17 17 17 17 17 17 17 17 16 16 16 36 37 36 37 
38 39 38 39 38 39 38 39 38 39 38 39 38 39 38 39 38 39 38 39 38 39 38 39 38 39 
36 37 36 37 36 37 36 37 36 37 36 37 36 37 36 37 36 37 36 37 36 37 36 37 36 37 
38 39 38 39 38 39 38 39 38 39 38 39 38 39 38 39 38 39 38 39 38 39 38 39 38 39 
36 37 36 37 36 37 36 37 36 37 36 37 36 37 36 37 36 37 36 37 36 37 36 37 36 37 
