27
17
38 38 38 38 38 38 38 22 23 22 23 22 23 26 27 31 31 25 31 22 23 22 23 22 23 22 23 
35 35 35 35 35 35 35 20 21 20 21 20 21 28 29 31 25 31 31 20 21 20 21 20 21 20 21 
16 16 13 13 13 13 13 13 13 16 16 16 16 26 27 19 19 19 19 19 19 19 19 19 19 19 32 
16 16 12 12 12 12 12 12 12 16 16 16 16 28 29 18 14 15 18 18 18 18 18 18 18 18 32 
35 35 35 35 35 35 35 35 35 35 16 16 16 30 24 16 16 16 16 17 17 17 17 17 17 17 32 
25 19 19 19 19 19 19 19 19 19 19 19 24 30 24 16 14 15 16 35 35 35 35 35 35 35 35 
24 18 18 18 18 18 18 18 18 18 18 24 24 30 24 16 16 16 16 36 36 36 36 36 36 36 36 
25 16 16 16 30 35 35 35 35 35 35 35 35 25 39 16 14 15 16 16 16 16 16 16 16 16 30 
24 16 16 30 30 6 6 6 2 3 6 6 6 39 39 17 17 17 17 17 17 17 16 16 16 16 30 
25 16 16 7 7 7 7 7 4 5 7 7 7 39 39 39 39 39 39 39 39 39 16 16 16 16 30 
24 17 17 7 7 7 7 7 7 7 7 7 7 6 6 6 6 6 6 6 6 24 24 7 7 7 25 
24 24 30 10 10 10 10 10 10 10 10 10 10 10 10 10 10 10 10 10 10 24 10 10 10 10 24 
34 34 30 7 7 30 7 1 7 7 1 7 8 8 8 8 8 7 7 7 7 24 10 10 10 24 24 
34 34 25 9 9 25 9 9 25 9 9 9 30 26 27 22 23 9 9 9 9 9 9 9 9 9 39 
34 34 30 7 7 30 7 7 30 7 7 7 30 28 29 20 21 22 23 8 8 8 8 8 8 8 39 
34 34 25 7 7 25 7 7 25 7 7 7 30 33 33 33 33 20 21 22 23 35 35 35 35 26 27 
34 34 30 11 11 30 11 11 30 11 11 11 30 33 33 33 33 33 33 20 21 31 25 31 25 28 29 
