27
16
30 31 27 26 27 26 27 27 39 32 39 32 39 32 39 32 39 36 37 38 38 38 38 38 38 38 38 
28 29 16 16 16 16 16 16 26 10 10 10 10 10 10 10 10 34 35 9 0 0 9 0 0 9 38 
30 31 16 16 16 4 16 16 26 11 5 6 11 11 11 11 11 7 7 0 0 0 0 0 0 0 38 
28 29 16 16 16 16 16 16 26 11 11 11 11 11 11 11 11 8 7 0 0 0 0 0 0 0 38 
16 16 16 16 16 4 16 16 26 11 5 6 11 11 11 11 11 0 7 0 0 0 0 0 0 0 38 
16 16 16 16 16 16 16 16 11 11 11 11 11 11 13 11 11 0 7 0 0 0 0 0 0 0 39 
30 31 24 24 39 17 17 17 12 12 12 12 12 12 12 12 12 0 7 0 1 1 0 0 0 32 38 
28 29 24 39 24 24 39 24 20 20 20 20 20 20 20 20 20 25 25 27 21 21 26 0 0 0 38 
30 31 0 0 0 0 0 0 2 2 2 7 8 8 7 9 0 0 0 0 0 0 26 0 0 0 39 
28 29 0 0 0 0 0 0 3 3 3 7 18 19 7 1 1 1 0 0 0 0 26 32 0 0 38 
30 31 0 0 0 0 0 0 27 25 39 27 27 27 27 21 21 21 0 0 0 0 0 0 0 0 38 
28 29 0 0 0 0 0 0 7 27 27 0 0 38 0 0 7 0 0 1 0 0 0 0 0 0 38 
30 31 1 1 1 1 0 0 7 36 37 0 0 38 0 0 7 0 0 21 0 1 0 0 0 33 38 
28 29 21 21 21 21 0 0 7 34 35 0 0 38 0 0 7 0 0 7 0 21 0 1 24 24 24 
30 31 0 7 0 7 0 0 7 36 37 0 0 38 0 0 7 0 0 7 0 7 0 21 22 22 22 
28 29 0 7 0 7 0 0 7 34 35 0 0 38 0 0 7 0 0 7 0 7 0 7 22 22 22 
