27
17
30 22 23 22 23 22 23 22 23 22 23 22 23 22 23 22 23 22 23 22 23 22 23 22 23 22 23 
30 20 21 20 21 20 21 20 21 20 21 20 21 20 21 20 21 20 21 20 21 20 21 20 21 20 21 
30 11 11 11 11 11 11 11 11 11 11 11 11 22 23 18 18 18 18 18 18 18 18 18 18 26 27 
25 6 6 6 6 6 6 6 6 6 6 6 6 20 21 14 15 16 16 14 15 16 16 14 15 28 29 
30 10 10 10 10 10 10 10 10 10 10 10 10 22 23 19 19 19 19 19 19 19 19 19 19 19 34 
30 7 7 39 39 39 39 39 30 7 7 39 39 20 21 16 16 16 16 16 16 17 17 17 17 17 34 
30 9 9 9 9 9 9 9 30 2 3 7 7 22 23 16 16 16 16 16 16 39 39 39 39 39 39 
25 8 8 8 8 8 7 7 30 4 5 7 7 20 21 16 16 16 16 16 36 30 24 25 24 26 27 
30 39 39 39 39 39 7 7 30 39 39 7 7 22 23 16 16 16 16 36 36 30 25 24 25 28 29 
30 9 9 9 9 9 9 9 30 6 6 2 3 20 21 16 16 16 36 36 36 36 36 36 36 36 36 
30 7 7 8 8 8 8 8 30 7 7 4 5 25 25 18 18 18 18 18 18 18 18 18 18 18 30 
25 7 7 39 39 39 39 39 30 16 16 39 39 25 25 17 17 17 17 17 17 17 17 16 16 16 30 
30 10 10 10 10 10 10 10 30 16 16 16 16 35 35 35 35 35 35 35 35 35 25 16 16 16 30 
30 8 8 8 8 8 7 7 30 16 16 16 16 13 16 13 16 13 16 13 16 13 16 16 16 16 30 
30 39 39 39 39 39 11 11 30 39 39 17 17 12 17 12 17 12 17 12 17 12 17 17 17 17 30 
30 33 34 32 32 39 11 11 22 23 22 23 22 23 22 23 35 25 35 35 25 35 35 25 35 35 30 
30 33 34 32 32 39 11 11 20 21 20 21 20 21 20 21 31 25 31 31 25 31 31 25 31 31 30 
