26
16
38 39 38 39 38 39 38 39 33 19 19 19 25 25 19 19 19 33 38 39 38 39 38 39 38 39 
36 37 36 37 36 37 36 37 25 25 25 25 25 25 25 25 25 25 36 37 36 37 36 37 36 37 
38 39 18 18 18 18 18 17 17 17 17 17 17 17 17 17 17 17 17 16 16 16 16 16 38 39 
36 37 18 18 18 18 18 17 17 17 17 17 17 17 17 17 17 17 17 16 16 16 16 16 36 37 
38 39 18 18 18 18 18 17 17 17 17 17 17 17 17 17 17 17 17 16 16 16 16 16 38 39 
36 37 18 18 18 18 18 17 17 17 17 17 17 17 17 17 17 17 17 16 16 16 16 16 36 37 
38 39 18 18 18 18 18 17 17 17 17 17 17 17 17 17 17 17 17 16 16 16 16 16 38 39 
36 37 18 18 18 18 18 17 17 17 17 17 17 17 17 17 17 17 17 16 16 16 16 16 36 37 
38 39 18 18 18 18 18 17 17 17 17 17 17 17 17 17 17 17 17 16 16 16 16 16 38 39 
36 37 18 18 18 18 18 17 17 17 17 17 17 17 17 17 17 17 17 16 16 16 16 16 36 37 
38 39 18 18 18 18 18 17 17 17 17 17 17 17 17 17 17 17 17 16 16 16 16 16 38 39 
36 37 18 18 18 18 18 17 17 17 17 17 17 17 17 17 17 17 17 16 16 16 16 16 36 37 
38 39 18 18 18 18 18 17 17 17 17 17 17 17 17 17 17 17 17 16 16 16 16 16 38 39 
36 37 18 18 18 18 18 17 17 17 17 17 17 17 17 17 17 17 17 16 16 16 16 16 36 37 
38 39 38 39 38 39 38 39 38 39 38 39 38 39 38 39 38 39 38 39 38 39 38 39 38 39 
36 37 36 37 36 37 36 37 36 37 36 37 36 37 36 37 36 37 36 37 36 37 36 37 36 37 
