20
15
39 39 20 20 20 20 20 20 20 20 20 20 20 20 20 20 20 20 39 39 
30 31 16 16 16 16 16 16 16 16 16 16 16 16 16 16 16 16 30 31 
28 29 16 16 16 16 16 16 16 5 6 16 16 16 16 16 16 16 28 29 
30 31 16 16 16 16 16 16 16 16 16 16 16 16 16 16 16 16 30 31 
28 29 16 16 16 16 16 16 16 5 6 16 16 16 16 16 16 16 28 29 
30 31 27 27 27 16 16 16 16 16 16 16 16 16 16 27 27 27 30 31 
28 29 16 16 16 16 16 16 16 16 16 16 16 16 16 16 16 16 28 29 
30 31 4 16 16 16 16 20 20 20 20 20 20 16 16 16 16 4 30 31 
28 29 16 16 16 16 16 16 16 16 16 16 16 16 16 16 16 16 28 29 
30 31 27 27 27 16 16 16 16 5 6 16 16 16 16 27 27 27 30 31 
28 29 16 16 16 16 16 16 16 16 16 16 16 16 16 16 16 16 28 29 
30 31 16 16 16 16 16 16 16 16 16 16 16 16 16 16 16 16 30 31 
28 29 17 17 17 17 17 17 17 17 17 17 17 17 17 17 17 17 28 29 
30 31 24 24 24 24 24 24 24 36 37 24 24 24 24 24 24 24 30 31 
28 29 22 22 22 39 22 22 22 34 35 22 22 22 39 22 22 22 28 29 
