68
22
30 31 27 30 31 30 31 30 31 30 31 30 31 30 31 30 31 30 31 30 31 30 31 30 31 30 31 30 31 30 31 30 31 30 31 30 31 30 31 30 31 36 37 23 23 23 23 23 23 23 23 23 23 23 23 23 23 23 23 23 23 23 23 23 23 23 26 25 
28 29 27 28 29 28 29 28 29 28 29 28 29 28 29 28 29 28 29 28 29 28 29 28 29 28 29 28 29 28 29 28 29 28 29 28 29 28 29 28 29 34 35 24 24 24 24 24 24 24 24 24 24 24 24 24 24 24 24 24 24 24 24 24 24 24 26 25 
30 31 16 16 16 16 16 16 16 16 16 16 16 16 30 31 10 16 10 16 10 16 10 10 10 10 10 10 11 11 16 11 11 16 11 11 11 11 11 11 11 39 22 16 16 16 16 16 16 16 16 16 16 16 16 16 16 16 16 16 16 16 16 16 16 16 26 32 
28 29 16 16 16 16 16 16 16 16 16 16 16 16 28 29 11 16 11 16 11 16 11 11 11 11 11 11 11 11 16 11 11 16 11 11 11 11 11 11 11 25 22 16 11 11 11 11 11 11 11 11 11 11 11 11 11 11 11 11 11 11 11 11 11 11 26 39 
30 31 16 16 16 16 16 16 16 16 16 16 16 16 30 31 11 16 11 16 11 16 11 11 11 11 11 11 11 11 16 16 16 16 30 31 24 24 11 11 11 25 22 16 11 11 26 24 24 24 24 24 24 24 24 24 24 24 24 24 24 24 26 11 11 11 26 32 
28 29 16 16 16 16 16 16 16 16 16 16 16 16 28 29 11 16 11 16 11 16 11 11 11 11 11 11 11 11 16 15 16 16 28 29 11 11 11 11 11 39 22 16 11 11 11 16 11 11 16 11 11 16 11 11 11 11 11 11 11 11 27 11 11 11 26 39 
30 31 16 16 16 16 16 16 16 16 16 16 16 16 20 20 11 16 11 16 11 16 11 11 11 11 5 6 11 11 16 16 16 16 26 26 11 11 11 11 11 25 22 16 11 11 11 16 11 11 16 11 11 16 11 11 11 11 11 11 11 11 39 11 11 11 26 32 
28 29 16 4 5 6 16 16 16 16 16 16 16 16 11 11 13 16 14 16 15 16 11 11 11 11 5 6 11 11 16 11 11 16 26 26 11 11 11 24 24 25 22 24 24 24 24 24 24 24 24 24 24 24 24 26 11 11 11 11 11 11 27 11 11 27 26 39 
30 31 16 16 16 16 16 16 16 16 16 16 16 16 11 11 11 16 11 16 11 16 11 11 11 11 5 6 11 11 16 11 11 16 26 26 11 11 11 11 11 11 11 11 11 11 11 11 11 11 11 11 11 11 11 11 11 11 11 11 11 11 39 11 11 11 26 32 
28 29 17 17 17 17 17 17 17 17 17 17 17 17 12 12 12 17 12 17 12 17 12 12 12 12 12 12 12 12 17 17 17 17 26 26 12 12 12 12 12 12 12 12 12 12 12 12 12 12 12 12 12 12 12 12 12 12 12 12 12 12 32 11 11 11 26 39 
32 32 30 31 30 31 30 31 30 31 30 31 30 31 27 27 27 27 27 27 27 27 27 27 30 31 30 31 30 31 30 31 30 31 30 31 30 31 30 31 27 27 22 30 31 30 31 30 31 30 31 30 31 30 31 30 31 30 31 30 31 32 27 11 11 11 26 32 
32 32 28 29 28 29 28 29 28 29 28 29 28 29 24 24 39 24 24 39 24 24 39 24 28 29 28 29 28 29 28 29 28 29 28 29 28 29 28 29 27 27 22 28 29 28 29 28 29 28 29 28 29 28 29 28 29 28 29 28 29 32 39 27 11 11 26 39 
32 32 0 8 8 8 8 9 8 8 8 8 0 0 0 0 0 16 10 10 16 10 36 37 10 10 10 10 16 16 16 16 16 16 16 16 11 11 11 11 11 26 22 16 16 16 11 11 16 11 11 16 11 11 16 16 16 16 11 11 11 26 27 11 11 11 26 32 
20 20 0 0 0 0 0 0 0 0 0 0 0 0 0 0 0 16 11 14 16 11 34 35 11 14 11 11 16 16 16 16 16 16 16 16 11 11 11 11 11 26 22 16 16 16 11 16 16 11 16 16 11 16 16 16 16 16 11 11 11 26 27 11 11 11 26 39 
30 31 0 0 0 0 0 0 0 0 0 0 1 1 1 1 1 16 11 11 16 11 30 31 11 11 11 11 16 5 6 4 16 16 16 16 11 11 11 11 11 11 11 16 16 16 11 11 16 11 16 16 11 11 16 16 16 16 11 11 11 26 39 11 11 11 26 32 
28 29 0 0 0 0 0 0 0 0 0 0 21 21 21 21 21 16 11 11 16 11 28 29 11 11 11 11 16 5 6 4 16 16 16 16 11 11 11 11 11 11 11 16 16 16 11 16 16 11 16 16 11 16 16 16 16 16 11 11 11 26 27 11 11 27 26 39 
38 25 0 2 0 2 0 2 0 2 0 0 7 27 27 27 27 16 11 11 16 11 10 10 11 11 11 11 17 17 17 17 17 17 17 17 17 17 17 17 17 17 17 17 17 16 11 11 16 11 11 16 11 11 16 16 30 31 11 11 11 11 11 11 11 11 26 32 
7 26 0 3 0 3 0 3 0 3 0 0 7 0 7 36 37 25 25 11 16 11 11 11 11 11 11 12 33 24 24 24 24 24 24 24 24 24 24 24 24 24 33 30 31 16 16 16 16 16 16 16 16 16 16 16 28 29 17 17 17 17 17 17 17 17 26 39 
7 26 1 1 1 1 1 1 1 1 1 0 7 0 7 34 35 16 10 11 16 11 11 11 11 11 12 33 33 26 22 22 22 32 33 32 33 32 33 32 33 32 33 28 29 30 31 16 16 16 16 16 16 16 16 16 30 31 24 24 24 24 24 24 24 24 36 37 
7 26 21 21 21 21 21 21 21 21 21 0 7 0 7 30 31 16 11 13 16 11 11 11 11 12 33 33 33 26 22 22 22 32 33 32 33 32 33 32 33 32 33 33 33 28 29 30 31 16 16 16 16 16 16 16 28 29 22 22 22 22 22 22 22 22 34 35 
30 31 22 22 22 22 22 22 0 0 7 0 7 0 7 28 29 17 12 12 17 12 12 12 12 33 33 33 33 26 22 22 22 39 33 39 33 39 33 39 33 39 33 39 33 39 33 28 29 30 31 16 16 16 16 16 30 31 22 22 22 22 22 22 22 22 36 37 
28 29 22 22 22 22 22 22 0 0 7 0 7 0 7 32 32 27 27 27 27 27 27 27 27 27 27 27 27 27 27 27 27 27 27 27 27 27 27 27 27 27 27 25 25 25 25 25 25 28 29 16 16 16 16 16 28 29 22 22 22 22 22 22 22 22 34 35 
